10000000000000000000000000000000
00000000001000000000000000000000
10000000000000000000000000000000
00000000000000000000000000000002
00000000000000000000000000000000
00000000000000000000000000000000
00000000000000000000000000000000
00000000000000020000000000000000
00000000000000000000000000000000
00000000000000000002000000000000
00000000000000000002000000000200
00000000000000000000000000000020
00000000000000002000000000000000
00000000000000000200000000000002
00000000000000000200000000000000
00000000000000002000000000000000
00000000000000000000000000220000
00000000000000222222000022222222
00000000000000222222000022222222
10000000000000222222000022222222
20000000000000222222000022222222
20000000000000222222000022222222
10000000000000000000000000000000
20000000000000002000000000000000
00000000000000000200000000000000
00000000000000000200000000000000
00000000000000002000000000220000
