100000000000000000000000000000000000000000000000
000000000010000000000000000000000000000000000000
100000000000000000000000000000000000000000000000
000000000000000000000000000000000000000000000002
000000000000000000000000000000000000000000000000
000000000000000000000000000000000000000000000000
000000000000000000000000000000000000000000000000
000000000000000200000000000000000000000000000000
000000000000000000002000000000000000000000000000
000000000000000000022000000000000000000000000000
000000000000000000022000000000000000000000000200
000000000000000000002000000000000000000000000020
000000000000000020000000000000000000000000000000
000000000000000002000000000000000000000000000002
000000000000000002000000000000000000000000000000
000000000000000020000000000000000000000000000000
000000000000000000000000000000000000000000220000
000000000000002222222000000000000000000022222222
000000000000002222222000000000000000000022222222
100000000000002222222000000000000000000022222222
200000000000002222222000000000000000000022222222
200000000000002222222000000000000000000022222222
100000000000000000000000000000000000000000000000
200000000000000020000000000000000000000000000000
000000000000000002000000000000000000000000000000
000000000000000002000000000000000000000000000000
000000000000000020000000000000000000000000220000
