100000000000000000000000000001
101000000000111110000000000101
100000000100000000000000000001
100000000002222222210000000001
100000000002222222210000000001
100000000002222222200000000001
100001111002222222200111100001
100001111002222222200111100001
100001111000000000000111100001
100000000000000000000000000001
100000000000000000000000000001
100000000111100000011110000001
100000000111100000011110000001
100000000111100000011110000001
100000000111100000011110000001
100000000000000000000000000001
100000000000000000000000000001
100001111000111111000111100001
100001111000111111000111100001
100001111000111111000111100001
100001111000111111000111100001






